##########
##   #####
## # #   #
   #   #  
##########