####################
  #   ##     ## ####
# ###    ### ##    #
#     ## ### #### ##
######## ###      ##
##       ##  #######
#  ######   #      #
# ##      ### ####  
# ## #####     ## ##
#  #       ###    ##
####################