##############################
#  #     ##   ####      ##   #
##   ###  # ###    ### ##  # #
## ##   #    ## # ## #    ## #
#     # # ##  # #    # ##### #
  ##### # ### # ######      ##
####    #   # # #   ##### # ##
###  ###### # # ###    ## ##  
### ##  ### # # ##  ## #  ## #
#      #    ### ## ##### # # #
# ###### ###       #       # #
# ##     #   ### ##  ######  #
# ## ####### # # ## ####### ##
#  #         #   ##          #
##############################